Date & Time,Payment Type,To/From Account,Account Name,Amount,Transaction ID,Balance,Reference
14/03/2025 14:30,MOMO USER,2.33253E+11,Kojo Boadu,-44.54,5884878825,711.46,Airtime
11/03/2025 13:26,MOMO USER,2.33295E+11,Esi Forson,-37.29,5606140080,674.17,Medicine
18/03/2025 21:27,MOMO USER,2.33205E+11,Abigail Mensah,-11.42,5873044213,662.75,Electricity
22/03/2025 13:53,MOMO USER,2.3329E+11,Kofi Ofori,-46.3,5639567088,616.45,Electricity
28/03/2025 18:35,MOMO USER,2.33222E+11,Akosua Baah,-22.92,5015717424,593.53,Groceries
22/03/2025 15:36,MOMO USER,2.33249E+11,Prince Osei,-26.55,5174523490,566.98,Transport
27/03/2025 13:35,MOMO USER,2.33295E+11,Akosua Baah,-39.86,5759004800,527.12,Groceries
17/03/2025 17:13,MOMO USER,2.33288E+11,Ama Kwarteng,-25.59,5756548670,501.53,Rent
